8
8
42,42,55,42,42,55,42,42
0,0,0,0,0,0,0,0
48,0,0,0,0,0,0,0
49,0,0,0,0,0,0,0
0,0,50,51,52,67,0,54
0,0,0,0,0,0,0,54
56,0,0,0,0,0,0,0
57,0,0,0,0,0,0,53